GER	= "countries/Vanilla/Germany.txt"
ENG = "countries/Vanilla/United Kingdom.txt"
SOV = "countries/Vanilla/Soviet Union.txt"
SWE	= "countries/Vanilla/Sweden.txt"
FRA	= "countries/Vanilla/France.txt"
LUX	= "countries/Vanilla/Luxemburg.txt"
BEL	= "countries/Vanilla/Belgium.txt"
HOL	= "countries/Vanilla/Holland.txt"
CZE	= "countries/Vanilla/Czechoslovakia.txt"
POL	= "countries/Vanilla/Poland.txt"
AUS	= "countries/Vanilla/Austria.txt"
LIT	= "countries/Vanilla/Lithuania.txt"
EST	= "countries/Vanilla/Estonia.txt"
LAT	= "countries/Vanilla/Latvia.txt"
SPR = "countries/Vanilla/Spain.txt"
ITA = "countries/Vanilla/Italy.txt"
ROM = "countries/Vanilla/Romania.txt"
YUG = "countries/Vanilla/Yugoslavia.txt"
SER = "countries/Vanilla/Serbia.txt"
SWI = "countries/Vanilla/Switzerland.txt"
TUR = "countries/Vanilla/Turkey.txt"
GRE = "countries/Vanilla/Greece.txt"
ALB = "countries/Vanilla/Albania.txt"
NOR = "countries/Vanilla/Norway.txt"
DEN = "countries/Vanilla/Denmark.txt"
BUL = "countries/Vanilla/Bulgaria.txt"
POR = "countries/Vanilla/Portugal.txt"
FIN = "countries/Vanilla/Finland.txt"
IRE = "countries/Vanilla/Ireland.txt"
HUN = "countries/Vanilla/Hungary.txt"
AFG = "countries/Vanilla/Afghanistan.txt"
ARG = "countries/Vanilla/Argentina.txt"
AST = "countries/Vanilla/Australia.txt"
BHU = "countries/Vanilla/Bhutan.txt"
BOL = "countries/Vanilla/Bolivia.txt"
BRA = "countries/Vanilla/Brazil.txt"
CAN = "countries/Vanilla/Canada.txt"
CHI = "countries/Vanilla/China.txt"
CHL = "countries/Vanilla/Chile.txt"
COL = "countries/Vanilla/Colombia.txt"
COS = "countries/Vanilla/Costa Rica.txt"
ECU = "countries/Vanilla/Ecuador.txt"
ELS = "countries/Vanilla/El Salvador.txt"
ETH = "countries/Vanilla/Ethiopia.txt"
GUA = "countries/Vanilla/Guatemla.txt"
HON = "countries/Vanilla/Honduras.txt"
IRQ = "countries/Vanilla/Iraq.txt"
JAP = "countries/Vanilla/Japan.txt"
KOR = "countries/Vanilla/Korea.txt"
LIB = "countries/Vanilla/Liberia.txt"
MEX = "countries/Vanilla/Mexico.txt"
MEN = "countries/Vanilla/Mengkukuo.txt"
NEP = "countries/Vanilla/Nepal.txt"
NIC = "countries/Vanilla/Nicaragua.txt"
NZL = "countries/Vanilla/New Zealand.txt"
PAN = "countries/Vanilla/Panama.txt"
PER = "countries/Vanilla/Persia.txt"
PHI = "countries/Vanilla/Philippines.txt"
PRU = "countries/Vanilla/Peru.txt"
SAF = "countries/Vanilla/South Africa.txt"
SAU = "countries/Vanilla/Saudi Arabia.txt"
SIA = "countries/Vanilla/Siam.txt"
SIK = "countries/Vanilla/Sinkiang.txt"
TIB = "countries/Vanilla/Tibet.txt"
URG = "countries/Vanilla/Uruguay.txt"
VEN = "countries/Vanilla/Venezula.txt"
YUN = "countries/Vanilla/Yunnan.txt"
USA = "countries/Vanilla/USA.txt"
MON = "countries/Vanilla/Mongolia.txt"
TAN = "countries/Vanilla/Tannu Tuva.txt"
PAR = "countries/Vanilla/Paraguay.txt"
CUB = "countries/Vanilla/Cuba.txt"
DOM = "countries/Vanilla/Dominican Republic.txt"
HAI = "countries/Vanilla/Haiti.txt"
YEM = "countries/Vanilla/Yeman.txt"
OMA = "countries/Vanilla/Oman.txt"
SLO = "countries/Vanilla/Slovakia.txt"
RAJ = "countries/Vanilla/British Raj.txt"
CRO = "countries/Vanilla/Croatia.txt"
GXC = "countries/Vanilla/Guangxi.txt"
PRC = "countries/Vanilla/ComChina.txt"
SHX = "countries/Vanilla/Shanxi.txt"
XSM = "countries/Vanilla/Xibei San Ma.txt"
ICE = "countries/Vanilla/Iceland.txt"
LEB = "countries/Vanilla/Lebanon.txt"
JOR = "countries/Vanilla/Jordan.txt"
SYR = "countries/Vanilla/Syria.txt"
EGY = "countries/Vanilla/Egypt.txt"
LBA = "countries/Vanilla/Libya.txt"
WGR = "countries/Vanilla/West Germany.txt" #Problems with dual leaders. Need more work
DDR = "countries/Vanilla/East Germany.txt" #Problems with dual leaders. Need more work
PAL = "countries/Vanilla/Palestine.txt"
ISR = "countries/Vanilla/Israel.txt"
VIN = "countries/Vietnam.txt"
CAM = "countries/Cambodia.txt"
MAL = "countries/Malaysia.txt"
INS = "countries/Indonesia.txt"
LAO = "countries/Laos.txt"
MNT = "countries/Montenegro.txt"
UKR = "countries/Ukraine.txt"
GEO = "countries/Georgia.txt"
#KAZ = "countries/Kazakhstan.txt" #For a later time
AZR = "countries/Azerbaijan.txt"
ARM = "countries/Armenia.txt"
BLR = "countries/Belarus.txt"
ANG = "countries/Angola.txt"
MZB = "countries/Mozambique.txt"
ZIM = "countries/Zimbabwe.txt"
COG = "countries/Congo.txt"
KEN = "countries/Kenya.txt"
PAK = "countries/Pakistan.txt"
BOT = "countries/Botswana.txt"
MAN = "countries/Manchukou.txt"