#Europe
CAS = "countries/Europe/Castille.txt"
DAC = "countries/Europe/Dacia.txt"
VAL = "countries/Europe/Valois.txt"
PRT = "countries/Europe/Pruthenia.txt"
ANG = "countries/Europe/Anglia.txt"
GWR = "countries/Europe/Gudian Workers Republic.txt"
EES = "countries/Europe/Empire of the Everburning Sun.txt"
UIW = "countries/Europe/Union of Irish Workers.txt"
FLE = "countries/Europe/Ferraro-Lombard Empire.txt"
AKO = "countries/Europe/Akovitavia.txt"
MRU = "countries/Europe/Moravian Union.txt"
SUD = "countries/Europe/Sudkoln.txt"
FLA = "countries/Europe/Flanders.txt"
PIS = "countries/Europe/Pisa.txt"
LIV = "countries/Europe/Livonia.txt"
MES = "countries/Europe/Messene.txt"
PRS = "countries/Europe/Prussia.txt"
JMT = "countries/Europe/Jamtland.txt"
LTH = "countries/Europe/Lithuania.txt"
RAG = "countries/Europe/Ragusa.txt"
SIC = "countries/Europe/Sicily.txt"
SIL = "countries/Europe/Silesia.txt"
CRN = "countries/Europe/Cornwall.txt"
NRT = "countries/Europe/Northland.txt"
ICL = "countries/Europe/Iceland.txt"
NRG = "countries/Europe/Noregur.txt"
HAN = "countries/Europe/Hanover.txt"

#Americas
CLN = "countries/Americas/CLN.txt"
VIN = "countries/Americas/Vinland.txt"
VRI = "countries/Americas/Virgin Isles.txt"
SEV = "countries/Americas/Seville.txt"
TEJ = "countries/Americas/Tejas.txt"
DBU = "countries/Americas/De Burghia.txt"
CAJ = "countries/Americas/Cajamarca.txt"
PMP = "countries/Americas/Pampas.txt"
RIO = "countries/Americas/Pio Grande.txt"
TGR = "countries/Americas/Talamh Greine.txt"
NGR = "countries/Americas/New Granada.txt"
PAP = "countries/Americas/The Fraticelli Papacy.txt"

#Asia
KRE = "countries/Asia/Korea.txt"
ZHE = "countries/Asia/Zheng.txt"
TKH = "countries/Asia/Takahashi.txt"
BRU = "countries/Asia/Brunei.txt"
ATJ = "countries/Asia/Atjeh.txt"
BUR = "countries/Asia/Burma.txt"
SUI = "countries/Asia/Suidanzhou.txt"
SHN = "countries/Asia/Shan.txt"
SUK = "countries/Asia/Sukhotai.txt"
MKS = "countries/Asia/Makassar.txt"
CHM = "countries/Asia/Champa.txt"
CHG = "countries/Asia/Chagatai.txt"
OSS = "countries/Asia/Ossetia.txt"

#Middle East to India
GBG = "countries/MEtoIndia/Great Baghdad.txt"
MAM = "countries/MEtoIndia/Mamluks.txt"
SIS = "countries/MEtoIndia/Sistan.txt"
CEY = "countries/MEtoIndia/Ceylon.txt"
HMD = "countries/MEtoIndia/Hamadan.txt"

#Africa
AFR = "countries/Africa/Africa.txt"
FNJ = "countries/Africa/Funj.txt"
DMT = "countries/Africa/Damot.txt"
KBO = "countries/Africa/Kanem Bornu.txt"
SWA = "countries/Africa/Swahili.txt"